####################
#..............<...#
#..####........#...#
#..#..#........#...#
#..#..#.>......#..S#
#..####........#...#
#..................#
####################
