####################
#..................#
#..####........>...#
#..#..#........#...#
#..#..#.v......>..S#
#..####........#...#
#..................#
####################
